Afrikaans: Ek is lief vir WXY
Arabic: أنا أحب WXY
Azerbaijani: Mən WXY-ni sevirəm
Belarusian: Я люблю WxY
Bulgarian: Обичам WXY
Bengali: আমি WXY ভালবাসা
Bosnian: Volim WXY
Catalan: M&#39;encanta WXY
Cebuano: Ganahan ko sa WXY
Czech: Mám rád WXY
Welsh: Rwyf wrth fy modd WXY
Danish: Jeg elsker WXY
German: Ich liebe WXY
Greek: Αγαπώ το WXY
English: I love WXY
Esperanto: I love WXY
Spanish: Me encanta wxy
Estonian: Ma armastan WXY
Basque: WXY maite dut
Persian: من عاشق WXY هستم
Finnish: Rakastan WXY: tä
French: J&#39;aime WXY
Irish: Is breá liom WXY
Galician: Eu amo WXY
Gujarati: મને ડબ્લ્યુએક્સવાય છે
Hausa: Ina son WXY
Hindi: मुझे WXY बहुत पसंद है
Hmong: I love WXY
Croatian: Volim WXY
Haitian Creole: Mwen renmen WXY
Hungarian: Szeretem a WXY-t
Armenian: Ես սիրում եմ WXY- ին
Indonesian: Saya suka WXY
Igbo: M hụrụ WXY n&#39;anya
Icelandic: Ég elska WXY
Italian: Amo WXY
Hebrew: אני אוהב את WXY
Japanese: WXYが大好き
Javanese: Aku seneng WXY
Georgian: მე მიყვარს WXY
Kazakh: WXY-ді жақсы көремін
Khmer: ខ្ញុំស្រលាញ់ WXY
Kannada: ನಾನು WXY ಪ್ರೀತಿಸುತ್ತೇನೆ
Korean: 나는 WXY를 좋아한다.
Latin: I love WXY
Lao: ຂ້ອຍຮັກ WXY
Lithuanian: Man patinka WXY
Latvian: Es mīlu WXY
Malagasy: Tiako ny WXY
Maori: Aroha ahau ki a WXY
Macedonian: Го сакам WXY
Malayalam: ഞാൻ ഇഷ്ടപ്പെടുന്നു
Mongolian: Би WXY-д хайртай
Marathi: मला डब्ल्यूएक्सवाय आवडते
Malay: Saya suka WXY
Maltese: Inħobb WXY
Myanmar (Burmese): ငါ WXY ကိုချစ်
Nepali: म WXY लाई माया गर्छु
Dutch: Ik ben dol op WXY
Norwegian: Jeg elsker WXY
Chichewa: Ndimakonda WXY
Punjabi: ਮੈਨੂੰ WXY ਪਸੰਦ ਹੈ
Polish: Uwielbiam WXY
Portuguese: Eu amo WXY
Romanian: Îmi place WXY
Russian: Я люблю WXY
Sinhala: මම WXY වලට ආදරෙයි
Slovak: Milujem WXY
Slovenian: Obožujem WXY
Somali: Waan jeclahay WXY
Albanian: I love WXY
Serbian: Волим ВКСИ
Sesotho: Ke rata WXY
Sundanese: Abdi bogoh WXY
Swedish: Jag älskar WXY
Swahili: Ninapenda WXY
Tamil: நான் WXY நேசிக்கிறேன்
Telugu: నేను WXY ప్రేమ
Tajik: Ман WXY дӯст медорам
Thai: ฉันรัก WXY
Filipino: Gustung-gusto ko ang WXY
Turkish: WXY&#39;yi seviyorum
Ukrainian: Я люблю WXY
Urdu: میں WXY سے محبت کرتا ہوں
Uzbek: WXY-ni yaxshi ko&#39;raman
Vietnamese: Tôi yêu WXY
Yiddish: איך ליבע ווקסי
Yoruba: Mo nifẹ WXY
Chinese: 我爱WXY
Chinese (Traditional): 我愛WXY
Zulu: Ngithanda i-WXY